1111111111111111111111111111111111111111111111111
100C1P10000000000000000010000000C00000000000001E1
1010001000111111000111111010000111111011101110111
1011111000000001000100101010000000001110111011101
10000000000000010000C0000010000000000000000000001
1111111111111111111111111111111111111111111111111
