111111111111111111111
100P00001C00000000001
100010000000000000001
111111111011111111111
100000010000000001001
100000010000000000001
100011110100000000001
100000000001000001001
111111111111111111111
