11111111111111111111111111111111111111
100P00001C0000010000100000011111111111
10001000000000000E00100000011111111111
11111111101111111111100000011111111111
100000010000000001C0100000011111111111
10000001000000000000100000011111111111
100011110100000C0000100000011111111111
100C0000000100000100100000011111111111
1111111111111111111111111111111111111
