1111111111111111111111111111
100P00001C000001000010000001
1000100000000000E00001000001
1111111110111111111110000001
100000010000000001C010000001
1000000100000000010110000001
100011110100000C000010000001
100C000000010000010010000001
1111111111111111111111111111
