111111111
1CE000001
111000001
100000001
100000001
100000001
1C00P0001
111111111
