1111111111111111
1C1001000010E001
10010100P0001011
10000000000CC001
1111111111111111
