1111111111111111111111111111
100000001C000001001010000001
10001000100000000000001000E1
111111111C111111111111111111
1000000100000000010000000001
1000000100000000010110000001
1000111101000000000010000001
10P0000000010000010010000011
1111111111111111111111111111
1111111111111111111111111111
