1111111111111111
1C100100001CE001
10010100P0001011
1000000000001001
1111111111111111
